我们	我们	我们
一个	他们	一个
没有	一个	他们
自己	没有	什么
他们	什么	一样
什么	自己	看到
因为	但是	没有
然而	看见	起来
这样	这样	你们
现在	这个	出来
就是	事情	父亲
所以	你们	母亲
时候	现在	自己
对于	声音	不是
可以	已经	这个
已经	起来	就是
而且	觉得	知道
起来	觉新	眼睛
人们	觉民	感到
于是	知道	女人
不能	不是	好像
知道	忽然	那些
东西	一点	已经
不是	不过	那个
以为	淑华	身体
一切	她们	然后
中国	那个	这样
文学	出来	还是
自然	时候	孩子
艺术	能够	听到
觉得	听见	爷爷
不过	眼睛	脸上
还是	不要	怎么
先生	不会	一声
一样	母亲	它们
一种	脸上	两个
怎样	下去	一条
虽然	答道	如果
生活	可以	看着
这些	应该	都是
一点	以后	一只
但是	地说	奶奶
那里	还是	儿子
看见	淑英	地上
还有	而且	下来
应该	眼光	身上
一面	问道	也是
之后	就是	声音
许多	为什么	姑姑
一般	怎么	因为
